600
##################
#$  ==      =#=  #
## ==   #        #
##  == ### =     #
#       #  = === #
#   =   ==       #
#  # ==          #
#    ==   ====== #
#    ==  ###     #
#    ####        #
#   #### ===   ==#
#        =##     #
#        ===   # #
#  ==   =====    #
#       =   =    #
#  ===    ###    #
#   =   #   ##   #
##################