360
##################
#     =## #    = #
###=   =#   =    #
#  =   ##   ###  #
#  #   =#   ##   #
#    =#####  =  ##
##    =      #  =#
#  =    #     =  #
# ##  #     #   =#
#  #  =  #  # #  #
####     =  ######
#  #  # ##  # =  #
# =#    =   #   =#
#    =#  #  =    #
#=   =   =#   #  #
## #  #     =#=  #
#        #       #
##################