18
##################
#                #
#                #
#                #
#      !         #
#                #
#       !        #
#                #
#       !        #
#                #
#     !          #
#                #
#                #
#      !         #
#                #
#                #
#                #
##################