480
##################
#    ==#==  #   ##
#  =#     #   =  #
#   =      #     #
# =    #   #  # =#
#  =      #      #
#     #=     #   #
#  #    =    #   #
#  =   = #  =    #
# #    =      #  #
#           #    #
# #  # #   =     #
#             =  #
#   #  =   #  =  #
# =         = =  #
#  =# # # = = =  #
#  =    =        #
##################