420
##################
#   =#     #     #
#=  #   =#  #   ##
# =    =      =  #
##    =  =     = #
###  =   # # #  =#
##   # =    #    #
#     =    # #  =#
#=  =  =##   =   #
#   =#     # #  ##
#= #   #    #   =#
#  #   =   # #   #
#      #=  =     #
# #= #      # # =#
#   # ==  =# #   #
#   # =    =     #
#   = # #    =  =#
##################