360
##################
#  =#            #
#   #  =#==#  #  #
#  #  =#== #  =  #
#    ##==  #  #  #
# = ##===# #  =  #
# ==  #    =  =  #
####=  = = ===== #
# ==  # =        #
# = ##=  ##  # # #
#    ##=         #
#=   =   = # =# =#
#  #   #         #
#=  #   =   #  # #
#   = #   #      #
#==    #   =  #  #
#   =   =   #    #
##################