420
##################
#$ #  =  #    #  #
##       ===     #
#   # #  #   #  =#
#   =    ##      #
#   =   ##==##= =#
#   # =# =  ==  ##
#                #
# ######    #   =#
#      #    #   ##
# ###########   =#
# #    #         #
# #    ######   =#
#                #
# =  =##=# =    ##
##          # =  #
#  #  #=#   # #  #
##################