18
##################
# = ==      =#=  #
## ==   #   !    #
##  == ### =     #
#       #  = === #
#   =   ==       #
#  # ==      !   #
#    ==   ====== #
#    ==  ###!    #
#    ####        #
#   #### ===   ==#
# !      =##     #
#        ===   # #
#  ==   =====    #
#  !    =   =    #
#  ===    ###    #
#   =   #   ##  $#
##################

# is stone
! is bot
= is brick