18
##################
#$  ==      =#=  #
## ==   #   !    #
##  =  ### =     #
#       #  = === #
#   =   ==       #
#  # ==      !   #
#    ==   ====== #
#    ==  ### !   #
#    ####        #
#   #### ===   ==#
# !      =##     #
#        ===   # #
#  ==   =====    #
#  !    =   =    #
#  ===    ###    #
#   =   #   ##   #
##################

# is stone
0 - 4 is bot
= is brick
$ is bomberman