480
##################
#  =     #    #  #
##  = ====    =  #
#    #     #=    #
#        #      =#
#   #   =    #   #
#  =   =    #   =#
# #   #    = #   #
#=       #     ==#
#  =   =    =    #
##    #          #
#       # =   =  #
##=  =     #     #
#      #  =      #
##   #     =     #
#    ==  ===#    #
#  =   ======    #
##################