600
##################
#$  ==      #==  #
#=  =#  #     #  #
##  ==  ## =     #
#   =   #=   ====#
#       ==       #
#=##  =      #   #
#     =   ====== #
# #   =   ##     #
#==    =##       #
#     ##   =   ==#
#  #     =##     #
#        = =   # #
#  ==   =  ==    #
#       =   =#   #
#  = =     ##    #
#  #=#  #   #    #
##################