540
##################
#$    =#      #  #
#=#      #    =  #
# #=   #=  =     #
#           #   ##
# # = =#=   =    #
# #   =    =   = #
#     #=#   #    #
#   =   =   =   =#
# #   =#=        #
# #   #    #  =  #
# =   =#         #
#     =    =     #
# =    #=  #   = #
# #  =     =     #
#     =#   #  =  #
#   #         #  #
##################