540
##################
#$#           =  #
#  =   =#=   #   #
#   #      =     #
#    =   #   #=  #
#  #   #=    #=  #
#=    #  #   #=  #
#   =            #
#  #  =#=#=#=    #
#     #      =  =#
#  =  ==#=#=   #=#
#     #          #
# = # ==###=#   ##
# # = #=#        #
#     #  =     #=#
#  #  #==    ==#=#
#     =          #
##################